NO textures/north.xpm
SO textures/south.xpm
WE textures/west.xpm
EA textures/east.xpm

F 18,53,25
C 153,204,255

1111
1W11
1111
