NO textures/north.xpm
SO textures/south.xpm
WE textures/west.xpm
EA textures/east.xpm

     F 164,169,208
     C 153,24,33

    111111111111111111
    10000000 010000001
    10N001110000011111
    100000010001110101
    100001100000111001
    100001000000111001
    100001000010000011
    110000010111111011
    110011001000000001
    100000000000000001
    111011110010001101
    111100000111111001
    111001000011111111
    100001000010010011
    111000010101111011
    100000001110101111
    111001000111111101
    111111000000000001
    111111011111110001
    111110000011111001
    111100000000111001
    111000001111101111
    111000011010001111
    111000000111111001
    111111000000000011
    111110001000111111
    111101110011111101
    111100011111001111
    111111000001000001
    111111111111111111