NO textures/north.xpm
SO textures/south.xpm
WE textures/west.xpm
EA textures/east.xpm
EA textures/east.xpm
     F 164,169,208
     C 153,24,33

    111111111111111111
    1011110000010000001
    1011001110000011111
    101110010001110101
    100001100000111001
    100001000000111001
    100001000010000011   
    110000010111111111
    110011001001111111
    100000000001
    111011110011111111
    11110000111111001
    111001000011111111
    100001000010010011
    1110000101N1111011
    100000001110101111
    111001000111111101
    111111000000000001
    111111011111110001
    111110000011111001
    111100000000111001
    111000001111101111
    111000011010001111
    111000000111111001
    111111000000000011
    111110001000111111
    111101110011111101
    111100011111001111
    111111001 11000001
    111111111 11111111