NO textures/north.xpm 

SO textures/south.xpm       
      WE textures/west.xpm        



EA textures/east.xpm         

C 153,24,33
 F 164,169,20            
11111111111111111111111111
11110000011111111111111111
11000011000000111111111111
11100000000000000000000011
11100000111000001110000011
10000000111100001111000111
11000000011111110000111111
10000000000000000000000001
1111111110000N0001111111111
11111110000111000000000011
11111110000111100000000011
11110001000000000000000011
10000001111111111000000011
11111100001111110011100111
11111111000111110011100111
11111100000011110011100111
11111111000000000000000111
10000000111111111100000111
11110000000001111111100111
11100000000000000000000011
11100000111000001110000011
10000000111100001111000111
11000000011111110000111111
10000000000000000000000001
11111111100000001111111111
11111110000111000000000011
11111110000111100000000011
11110001000000000000000011
10000001111111111000000011
11111100001111110011100111
11111111000111110011100111
11111100000011110011100111
11111111000000000000000111
10000000111111111100000111
11110000000001111111100111
11111111111111111111111111