NO textures/north.xpm
  SO textures/south.xpm     
    
    WE textures/west.xpm


EA textures/east.xpm

F 0,2,10
C 255,123,45

   1
 11011        111111111111111111111111
1000001      10000000000000000100000011
 11011   11 1110110000N0101000101000101
1  1    100100000001000001000010111111
11111111101100000011000000000101
100000000011000000000000000011111
11110111111111000010000010001
11110111111111011100010010001
11000000110101011100000010001
10000000000000001100000010001
10000000000000001101010010001
1100000111010100111101111000111
11110111 1110101 101111010001
11111111 1111111 11111111111
